000000000000000000000000000000000000000000000000000000000000000000000000000000000000000000000000000000000000000000000000000000000000000000000000
000000000000000000000000000000000000000000000000000000000000000000000000000000000000000000000000000000000000000000000000000000000000000000000000
000000000000000000000000000000000000000000000000000000000000000000000000000000000000000000000000000000000000000000000000000000000000000000000000
000000000000000000000000000000000000000000000000000000000000000000000000000000000000000000000000000000000000000000000000000000000000000000000000
000000000000000000000000000000000000000000000000000000000000000000000000000000000000000000000000000000000000000000000000000000000000000000000000
000000000000000000000000000000000000000000000000000000000000000000000000000000000000000000000000000000000000000000000000000000000000000000000000
000000000000000000000000000000000000000000000000000000000000000000000000000000000000000000000000000000000000000000000000000000000000000000000000
000000000000000000000000000000000000000000000000000000000000000000000000000000000000000000000000000000000000000000000000000000000000000000000000
000000000000000000000000000000000000000000000000000000000000000000000000000000000000000000000000000000000000000000000000000000000000000000000000
000000000000000000000000000000000000000000000000000000000000000000000000000000000000000000000000000000000000000000000000000000000000000000000000
000000000000000000000000000000000000000000000000000000000000000000000000000000000000000000000000000000000000000000000000000000000000000000000000
000000000000000000000000000000000000000000000000000000000000000000000000000000000000000000000000000000000000000000000000000000000000000000000000
000000000000000000000000000000000000000000000000000000000000000000000000000000000000000000000000000000000000000000000000000000000000000000000000
000000000000000000000000000000000000000000000000000000000000000000000000000000000000000000000000000000000000000000000000000000000000000000000000
000000000000000000000000000000000000000000000000000000000000000000000000000000000000000000000000000000000000000000000000000000000000000000000000
000000000001111111111111111111111111111111111111100000000000000000000000000000000000000000000000000000000000000000000000000000000000000000000000
000000000001111111111111111111111111111111111111100000000000000000000000000000000000000000000000000000000000000000000000000000000000000000000000
000000000001111111111111111111111111111111111111100000000000000000000000000000000000000000000000000000000000000000000000000000000000000000000000
000000000001111111111111111111111111111111111111100000000000000000000000000000000000000000000000000000000000000000000000000000000000000000000000
000000000001000000001000000000000100000000000000100000000000000000000000000000000000000000000000000000000000000000000000000000000000000000000000
000000000001000000001000000000000110000000000000100000000000000000000000000000000000000000000000000000000000000000000000000000000000000000000000
000000000001000000011111111111111100000000000000111111111111111111111111111111111111111111111111111111111111111111111111100000000000000000000000
000000000001000000000101000010001000000000000000111111111111111111111111111111111111111111111111111111111111111111111111100000000000000000000000
000000000001000000000000000000000000000000000000111111111111111111111111111111111111111111111111111111111111111111111111100000000000000000000000
000000000001000000000000000000000000000000000000111111111111111111111111111111111111111111111111111111111111111111111111100000000000000000000000
000000000001000000000000000000000000000000000000100000000000000000001010101000000000000000000000000010011100001110011100100000000000000000000000
000000000001000000000000000000000000000000000000000000001000000000000000000000000000000000000000000010011100001110011100100000000000000000000000
000000000001111101111011110111100000000000000000000000011111111000000000000000001111100001111100000010011100001110011100100000000000000000000000
000000000001111101111011110111100000000000000000000000111111111100001111111110001111100001111100000010011100001110011100100000000000000000000000
000000000001000000000000000000000000000000000000000000111111111100001111111110001111100001111100000010000000000000000000100000000000000000000000
000000000001000000000000000000000000000000000000000000011110111000001111111110001111100001111100000010011100001110011100100000000000000000000000
000000000001111101111011110111100000000000000000100000001000010000001111111110000000000000000000000010011100001110011100100000000000000000000000
000000000001111101111011110111100000000000000011100000001000010000001111111110001111100001111100000010011100001110011100100000000000000000000000
000000000001000000000000000000000000000000000111100000000000000000001111111110001111100001111100000010011100001110011100100000000000000000000000
000000000001000000000000000000000000000000000111100000000000000000001111111111001111100001111100000010000000000000000000100000000000000000000000
000000000001111111111111111111111111111000001111100000000000000000011111111110001111100001111100000011111110001111111111100000000000000000000000
000000000001111111111111111111111111111000001111100000000000000000000101010100001111100001111100000011111110001111111000000000000000000000000000
000000000001111111111111111111111111111000001111100000000000000000000000000000001111100001111100000011111111011111111000000000000000000000000000
000000000001111111111111111111111111111000001111100000000000000000000000000000001111100001111100000011111111011111111000000000000000000000000000
000000000001000000000000000000000010101000001010000000000000000000000000000000000000000000000000000000000000000000001000000000000000000000000000
000000000001000000000000000000000000000000000011111100001111110000111111000000001111100001111100000000000000000000001000000000000000000000000000
000000000001000000000000000000000000000000000111111110011111111001111111100000001111100001111100000000000000000000001000000000000000000000000000
000000000001000111000011100001110000111000000011111100001111110000111111000000001111100001111100000000000000000000001000000000000000000000000000
000000000001000111000011100001110000111000000000110000000011000000001100000000000000000000000000000011111100000011111111111111111110000000000000
000000000001000011000001100000110000110000000000000000000000000000000000000000000001111111110000000011111100000011111111111111111110000000000000
000000000001000000000000000000000000000000000000000000000000000000000000000000001111000000011110000011111100000011111111111111111110000000000000
000000000001000000000000000000000000000000000011111100001111110000111111000000001100011111000010000011111100000011111111111111111110000000000000
000000000001000000000000000000000000000000000111111110011111111001111111100000001100011111000010000010000100000010101010000000000010000000000000
000000000001000000000000000000000000111000000011111100001111110000111111000000001100011111000010000010111100000000000010000000000010000000000000
000000000001000111000011100001110000111000000000110000000011000000001100000000001100100000100010000010011000000000000010000000000010000000000000
000000000001000111000011100001110000110000000000000000000000000000000000000000001111100000111110000010111100000000000010000000000010000000000000
000000000001000011000001100000110000000000000000000000000000000000000000000000000001111111110000000010000000000000000010000000000010000000000000
000000000001000000000000000000000000000000000011111100001111110000111111000000000000000000000000000000000000000000000010000000000010000000000000
000000000001000000000000000000000000000000000111111110011111111001111111100000000000000000000000000000000000000000000011111111111110000000000000
000000000001000000000000000000000000000000000011111100001111110000111111000000000000000000000000000000000000000000000011111111111110000000000000
000000000001000000000000000000000000111000000000110000000011000000001100000000000000000000000000000010000000000000000011111111111110000000000000
000000000001000111000011100001110000111000000000000000000000000000000000000000000000000000000000000010000000000000000011111111111110000000000000
000000000001000111000011100001110000110000000000000000000000000000000000000000000000000000000000000010000000000000000010000000000010000000000000
000000000001000011000001100000110000000000000000000000000000000000000000000000000000000000000000000010000000000000000010000000000010000000000000
000000000001000000000000000000000000000001111110000111111111111111111111111111111100000000000111111110010000000000000010000000000010000000000000
000000000001000000000000000000000000000001111110000111111111111111111100011111110111111111111100000011111000000000000010000000000010000000000000
000000000001000000000000000000000000000001111110000111111111111111111100011111110000000000000000000010001100000000000010000000000010000000000000
000000000001000000000000000000000000111001111110000111111111111111111100011111110000000000000000000010001100000000000011111111111110000000000000
000000000001000111000011100001110000111001010010000000000000001100000000000000010000000000000000000010001000000000000011111111111110000000000000
000000000001000111000011100001110000110001110111001111101111100100000000000000010000000000000000000010001000000000000011111111111110000000000000
000000000001000011000001100000110000000001111011000111000111000100111000001110010000000000000000000010001100000000000011111111111110000000000000
000000000001000000000000000000000000000001010010000000000000000100111000001110010000000000000000000010001000000000000010000000000010000000000000
000000000001000000000000000000000000000001000000000000000000000100111000001110010000000000000000000010001000000000000010000000000010000000000000
000000000001000000000000000000000000000000000000000101000101000100000000000000010000000000000000000011111000000000000010000000000010000000000000
000000000001000000000000000000000000000000000000001111101111100100000000000000010000000000000000000011010000000000000010000000000010000000000000
000000000001000000000000000000000000000000000000000111000111000100111000001110010000000000000000000010000000000000000010000000000010000000000000
000000000001000000000000000000000000000001010010000000000000000100111000001110010000000000000000000010000000000000000010000000000010000000000000
000000000001111110000111111111110000111111111011001111101111100100111000001110010000000000000000000011111111111111111111111111111110000000000000
000000000001111110000111111111110000111111110111000111000111000100000000000000010000000000000000000000000000000000000000000000000000000000000000
000000000001111110000111111111110000111111010010000000000000000100000000000000010000000000000000000000000000000000000000000000000000000000000000
000000000001111110000111111111110000111111111111111111111111111111111111111111110000000000000000000000000000000000000000000000000000000000000000
000000000001000010000010001000100000111111000000000000000000000000000000000000000000000000000000000000000000000000000000000000000000000000000000
000000000001000000000010001000100000000001000000000000000000000000000000000000000000000000000000000000000000000000000000000000000000000000000000
000000000001000000000011111111100000000001000000000000000000000000000000000000000000000000000000000000000000000000000000000000000000000000000000
000000000001000000000011111111100000000001000000000000000000000000000000000000000000000000000000000000000000000000000000000000000000000000000000
000000000001000000000011111111100000000001000000000000000000000000000000000000000000000000000000000000000000000000000000000000000000000000000000
000000000001000000000011111111100000000001000000000000000000000000000000000000000000000000000000000000000000000000000000000000000000000000000000
000000000001100000000010001000100000000011000000000000000000000000000000000000000000000000000000000000000000000000000000000000000000000000000000
000000000001100000000010001000100000000011000000000000000000000000000000000000000000000000000000000000000000000000000000000000000000000000000000
000000000001111111111111111111111111111111000000000000000000000000000000000000000000000000000000000000000000000000000000000000000000000000000000
000000000000000000000000000000000000000000000000000000000000000000000000000000000000000000000000000000000000000000000000000000000000000000000000
000000000000000000000000000000000000000000000000000000000000000000000000000000000000000000000000000000000000000000000000000000000000000000000000
000000000000000000000000000000000000000000000000000000000000000000000000000000000000000000000000000000000000000000000000000000000000000000000000
000000000000000000000000000000000000000000000000000000000000000000000000000000000000000000000000000000000000000000000000000000000000000000000000
000000000000000000000000000000000000000000000000000000000000000000000000000000000000000000000000000000000000000000000000000000000000000000000000
000000000000000000000000000000000000000000000000000000000000000000000000000000000000000000000000000000000000000000000000000000000000000000000000
000000000000000000000000000000000000000000000000000000000000000000000000000000000000000000000000000000000000000000000000000000000000000000000000
000000000000000000000000000000000000000000000000000000000000000000000000000000000000000000000000000000000000000000000000000000000000000000000000
000000000000000000000000000000000000000000000000000000000000000000000000000000000000000000000000000000000000000000000000000000000000000000000000
000000000000000000000000000000000000000000000000000000000000000000000000000000000000000000000000000000000000000000000000000000000000000000000000
000000000000000000000000000000000000000000000000000000000000000000000000000000000000000000000000000000000000000000000000000000000000000000000000
